####################################################################################################
#  #     #     #     #     #     #     #     #     #     #     #     #     #     #     ###         #
#  #  #  #  #  #  #  #  #  #  #  #  #  #  #  #  #  #  #  #  #  #  #  #  #  #  #  #  #  ###         #
#  #  #  #  #  #  #  #  #  #  #  #  #  #  #  #  #  #  #  #  #  #  #  #  #  #  #  #  #  ###         #
#  #  #  #  #  #  #  #  #  #  #  #  #  #  #  #  #  #  #  #  #  #  #  #  #  #  #  #  #  ###         #
#  #  #  #  #  #  #  #  #  #  #  #  #  #  #  #  #  #  #  #  #  #  #  #  #  #  #  #  #  ###         #
#  #  #  #  #  #  #  #  #  #  #  #  #  #  #  #  #  #  #  #  #  #  #  #  #  #  #  #  #  ###         #
#  #  #  #  #  #  #  #  #  #  #  #  #  #  #  #  #  #  #  #  #  #  #  #  #  #  #  #  #  ###         #
#  #  #  #  #  #  #  #  #  #  #  #  #  #  #  #  #  #  #  #  #  #  #  #  #  #  #  #  #   ##         #
#  #  #  #  #  #  #  #  #  #  #  #  #  #  #  #  #  #  #  #  #  #  #  #  #  #  #     ######         #
#  #  #  #  #  #  #  #  #  #  #  #  #  #  #  #  #  #  #  #  #  #  #  #  #     #######   ##         #
#  #  #  #  #  #  #  #  #  #  #  #  #  #  #  #  #  #  #  #  #  #  #     #######         ##         #
#  #  #  #  #  #  #  #  #  #  #  #  #  #  #  #  #  #  #  #  #     #######        #####  ##         #
#  #  #  #  #  #  #  #  #  #  #  #  #  #  #  #  #  #  #     #######        #######      ##         #
#  #  #  #  #  #  #  #  #  #  #  #  #  #  #  #  #     #######        #######        ######         #
#  #  #  #  #  #  #  #  #  #  #  #  #  #  #     #######        #######        #######   ##         #
#  #  #  #  #  #  #  #  #  #  #  #  #     #######        #######        #######         ##         #
#  #  #  #  #  #  #  #  #  #  #     #######        #######        #######        #####  ##         #
#  #  #  #  #  #  #  #  #     #######        #######        #######        #######      ##         #
#  #  #  #  #  #  #     #######        #######        #######        #######        ######         #
#  #  #  #  #     #######        #######        #######        #######        #######   ##         #
#  #  #     #######        #######        #######        #######        #######         ##         #
#  #  #######        #############  #######        #############  #######        #####  ##         #
#              ###################           ###################           #######                 #
####################################################################################################