####################################################################################################
#                                                                                        #         #
#######################################################################################  #         #
#                                                                                        #         #
#  #######################################################################################         #
#                                                                                        #         #
#######################################################################################  #         #
#                                                                                        #         #
#  #######################################################################################         #
#                                                                                        #         #
#######################################################################################  #         #
#                                                                                        #         #
#  #######################################################################################         #
#                                                                                        #         #
#######################################################################################  #         #
#                                                                                        #         #
#  #######################################################################################         #
#                                                                                        #         #
#######################################################################################  #         #
#                                                                                        #         #
#  #######################################################################################         #
#                                                                                        #         #
#######################################################################################  #         #
#                                                                                                  #
####################################################################################################