####################################################################################################
#        #                       #                 #                                    #          #
#  #  #  #############  #######  #  #####################################################          #
####  #  #              #     #     #              #                                    #          #
#     #  #############  #  #  #  ############  ##############  ##########################          #
#######                 #  #  #  #                 #           #                        #          #
#     #  #############  #  #  ####  #  #################  ###########################   #          #
#     #  #              #  #        #                                                   #          #
#  #  ####  #############  #  ####  ########  ###############  ##########################          #
#  #                    #  #  #  #  #                                                   #          #
#############  ##########  #  #  #  ##############  ##############  ################### #          #
#                          #  #             #                                           #          #
#  ####  #######  #######  ####  #  ##############  ########  ###########################          #
#  #  #        #  #        #  #  #  #               #                                   #          #
#  #  #  ####  #  #  ##########  #  ############################  #######################          #
#  #  #  #  #  #  #  #        #  #           #                    #                     #          #
#  #  #  #  #  #  #  #######  #  #  ######################  #############################          #
#  #  #  #  #  #  #           #  #  #        #                                          #          #
#  #  #  #  #  #  ##########  #  #  #######  ####  #############  ##################### #          #
#  #  #  #  #  #  #           #  #           #     #                                    #          #
#  #  #  #  ####  ##########  #  #  ###########  ###################  ###################          #
#  #     #                    #  #  #            #                                      #          #
#  ################  ##########  #  ##################################################  #          #
#                 #  #           #  #                                                              #
####################################################################################################