####################################################################################################
#      #############         #############         #############                        #          #
#####      #########  #####      #########  #####      #########  ####################  #          #
#########      #####      #####      #####      #####      #####      ###########       #          #
#############      #####      #####      #####      #####      #####      #######  ######          #
###         #####      #####      #####      #####      #####      #####      ###       #          #
###  #####      #####      #####      #####      #####      #####      #####    ######  #          #
###      #####      #####      #####      #####      #####      #####      ###  #       #          #
#######      #####      #####      #####      #####      #####      #####       #  ######          #
###########      #####      #####      #####      #####      #####      #########       #          #
#         #####      #####      #####      #####      #####      #####      ##########  #          #
#  #####      #####      #####      #####      #####      #####      #####      #       #          #
#      #####      #####      #####      #####      #####      #####      #####  #  ######          #
#####      #####      #####      #####      #####      #####      #####      #  #       #          #
#########      #####      #####      #####      #####      #####      #####     ######  #          #
#       #####      #####      #####      #####      #####      #####      #######       #          #
#  ###      #####      #####      #####      #####      #####      #####      ###  ######          #
#    #####      #####      #####      #####      #####      #####      #####    #       #          #
###      #####      #####      #####      #####      #####      #####      ###  ######  #          #
# #####      #####      #####      #####      #####      #####      #####       #       #          #
#     #####  #########      #####  #########      #####  #########      #########  ######          #
#  #         #############         #############         #############             ######          #
#  ######################################################################################          #
#                                                                                                  #
####################################################################################################