####################################################################################################
#                                #                                                      #          #
#   #   ##############  #######  #  #########  #########  ###############################          #
#   #   #            #  #     #  #  #              #                                    #          #
#   #   ##############  #######  ############  ##############  ##########################          #
#####   #            #  #  #  #  #                 #                                    #          #
#       ##############  #  #  #  #  #  #################  ###########################   #          #
#       #            #  #  #        #              #                #                   #          #
#   #   #################  #  ####  ########  ###############  ##########################          #
#   #                   #  #  #  #  #                               #                   #          #
#############  ##########  #  #  #  ##############  ##############  #####################          #
#                          #  #             #                                           #          #
#  ####  #######  #######  ####  #  ##############  ########  ###########################          #
#  #  #        #  #        #  #  #  #               #                                   #          #
#  #  #  ####  #  #  ##########  #  ############################  #######################          #
#  #  #  #  #  #  #  #        #  #           #                    #                     #          #
#  #  #  #  #  #  #  #######  #  #########################  #############################          #
#  #  #  #  #  #  #           #  #  #        #                                          #          #
#  #  #  #  #  #  ##########  #  #  #######  ####  ################  ####################          #
#  #  #  #  #  #  #           #  #           #     #                                    #          #
#  #  #  #  ####  ##########  #  #  ###########  ###################  ###################          #
#  #     #                    #  #  #            #                    #                 #          #
#  ################  ##########  #  ###########  ########################################          #
#                 #  #           #  #                                                              #
####################################################################################################