####################################################################################################
#    ###                #          #     ######                           #  #####  #     ##       #
#   #  #  #  ############  ######  #  #  #       #  ####################  #      #  #  #  ##       #
#   #  #  #  #             #    #     #  #  ######                     #  #####  #  #  #  ##       #
#   #  #  #  #  ############  ###  #  #  #  #       #################  #         #  #  #  ##       #
#   #  #  #  #            #     #  #  #  #  #  #######              #  #  #####  #  #  #  ##       #
#      #  #  #  ########  #  ####  #  #     #  #     #  #############  #  #      #  #  #  ##       #
#  #####  #  #         #  #  #     #  #  ####     #  #  #              #  #  #####  #  #  ##       #
#         #  #  #####  #  #  #  ####  #     #######  #  #  #############  #         #  #  ##       #
#  #####  #  #  #  #####        #     ####  #        #  #   #     #       ########  #  #  ##       #
#  #      #  #  #  #      ####  #  #     #  #  #######  ##  #  #  #  ######         #  #  ##       #
#  ########  #  #  #  ##  #     #  #  #  #  #  #     #  #   #  #  #     ##   ########  #  ##       #
#  #            #  #  #  ##  ####  #  #  #  #     #  #  #  ##  #  #  #  ##     #       #  ##       #
#  ###########  #  #  #  #   #     #  #  #  #######  #  ####   #  #  #  ##  #  #  ######  ##       #
####  #  #      #     #  #  ##  ####  #  #  #        #     #  ##  #  #  ##  #  #  ##  #   ##       #
#     #  #  #  ########  #  #   #     #  #  #  ##########  #  #   #  #  ##  #  #  ##  #  ###       #
#  ####  #  #  #         #  #  ##  ####  #  #  #        #  #  #  ##  #   ####  #      #  ###       #
#  #     #  #  #  ########  #  #   #     #  #     ####  #  #     #   ##   ###  #  ##  #  ###       #
#  #  ####  #  #  #         #  #  ##  ####  ####  #     #  ####  #    ##  #    #   #  #  ###       #
#  #  #     #  #  #  ########  #  #   #        #  #  #######  #  ###   ####  ####  #  #  ###       #
#  #  #  ####  #  #  #         #  #  ##   ###  #  #  #     #     #     #     #  #  #  #    #       #
#  #  #  #     #  #  #  ########  #   ##  #    #  #  ####  #######  ####  ####  #  #  ######       #
#  #  ####  ####  #  ####     #   ##   #  #  ###  #  #  #  #   ##   #     #     #  #     ###       #
#              #     #     #     ##########       #        ##      ##  #     #     ####  ###       #
####################################################################################################